"filename", "language", "C++", "Python", "comment", "blank", "total"
"/home/kapusta/Документы/programming_tasks/8/a.py", "Python", 0, 9, 0, 2, 11
"/home/kapusta/Документы/programming_tasks/8/testa.py", "Python", 0, 18, 0, 6, 24
"/home/kapusta/Документы/programming_tasks/CodeForcesRound/898/a.cpp", "C++", 27, 0, 0, 1, 28
"/home/kapusta/Документы/programming_tasks/CodeForcesRound/898/b.cpp", "C++", 33, 0, 2, 1, 36
"/home/kapusta/Документы/programming_tasks/CodeForcesRound/898/c.cpp", "C++", 34, 0, 0, 1, 35
"/home/kapusta/Документы/programming_tasks/CodeForcesRound/898/d.cpp", "C++", 26, 0, 0, 1, 27
"/home/kapusta/Документы/programming_tasks/CodeForcesRound/898/e.cpp", "C++", 27, 0, 3, 1, 31
"/home/kapusta/Документы/programming_tasks/CodeForcesRound/898/e2.cpp", "C++", 37, 0, 4, 1, 42
"/home/kapusta/Документы/programming_tasks/CodeForcesRound/898/e3.cpp", "C++", 36, 0, 1, 2, 39
"/home/kapusta/Документы/programming_tasks/CodeForcesRound/898/f.cpp", "C++", 45, 0, 0, 1, 46
"/home/kapusta/Документы/programming_tasks/CodeForcesRound/917/a.cpp", "C++", 27, 0, 0, 1, 28
"/home/kapusta/Документы/programming_tasks/CodeForcesRound/917/b.cpp", "C++", 27, 0, 2, 2, 31
"/home/kapusta/Документы/programming_tasks/CodeForcesRound/918/a.cpp", "C++", 19, 0, 0, 1, 20
"/home/kapusta/Документы/programming_tasks/CodeForcesRound/918/b.cpp", "C++", 54, 0, 0, 2, 56
"/home/kapusta/Документы/programming_tasks/CodeForcesRound/918/c.cpp", "C++", 24, 0, 0, 3, 27
"/home/kapusta/Документы/programming_tasks/CodeForcesRound/918/d.cpp", "C++", 45, 0, 0, 1, 46
"/home/kapusta/Документы/programming_tasks/CodeForcesRound/918/e.cpp", "C++", 41, 0, 0, 2, 43
"/home/kapusta/Документы/programming_tasks/CodeForcesRound/918/e2.cpp", "C++", 10, 0, 0, 2, 12
"/home/kapusta/Документы/programming_tasks/CodeForcesRound/919/a.cpp", "C++", 41, 0, 0, 1, 42
"/home/kapusta/Документы/programming_tasks/CodeForcesRound/919/b.cpp", "C++", 36, 0, 0, 1, 37
"/home/kapusta/Документы/programming_tasks/CodeForcesRound/920/a.cpp", "C++", 21, 0, 0, 1, 22
"/home/kapusta/Документы/programming_tasks/CodeForcesRound/920/b.cpp", "C++", 35, 0, 3, 1, 39
"/home/kapusta/Документы/programming_tasks/CodeForcesRound/920/b2.cpp", "C++", 50, 0, 3, 1, 54
"/home/kapusta/Документы/programming_tasks/CodeForcesRound/920/c.cpp", "C++", 36, 0, 4, 1, 41
"/home/kapusta/Документы/programming_tasks/CodeForcesRound/920/c2.cpp", "C++", 13, 0, 0, 3, 16
"/home/kapusta/Документы/programming_tasks/CodeForcesRound/921/a.cpp", "C++", 22, 0, 0, 1, 23
"/home/kapusta/Документы/programming_tasks/CodeForcesRound/921/b.cpp", "C++", 23, 0, 0, 1, 24
"/home/kapusta/Документы/programming_tasks/CodeForcesRound/921/b2.cpp", "C++", 26, 0, 0, 1, 27
"/home/kapusta/Документы/programming_tasks/CodeForcesRound/921/b3.cpp", "C++", 23, 0, 0, 1, 24
"/home/kapusta/Документы/programming_tasks/CodeForcesRound/921/c.cpp", "C++", 9, 0, 0, 2, 11
"/home/kapusta/Документы/programming_tasks/CodeForcesRound/922/a.cpp", "C++", 14, 0, 0, 1, 15
"/home/kapusta/Документы/programming_tasks/CodeForcesRound/922/b.cpp", "C++", 41, 0, 0, 3, 44
"/home/kapusta/Документы/programming_tasks/CodeForcesRound/922/c.cpp", "C++", 32, 0, 1, 2, 35
"/home/kapusta/Документы/programming_tasks/CodeForcesRound/922/c2.cpp", "C++", 35, 0, 1, 1, 37
"/home/kapusta/Документы/programming_tasks/CodeForcesRound/922/c3.cpp", "C++", 14, 0, 0, 1, 15
"/home/kapusta/Документы/programming_tasks/CodeForcesRound/926/a.cpp", "C++", 23, 0, 0, 1, 24
"/home/kapusta/Документы/programming_tasks/CodeForcesRound/926/b.cpp", "C++", 21, 0, 0, 1, 22
"/home/kapusta/Документы/programming_tasks/CodeForcesRound/926/c.cpp", "C++", 17, 0, 0, 1, 18
"/home/kapusta/Документы/programming_tasks/CodeForcesRound/927/a.cpp", "C++", 24, 0, 0, 1, 25
"/home/kapusta/Документы/programming_tasks/CodeForcesRound/927/b.cpp", "C++", 24, 0, 1, 2, 27
"/home/kapusta/Документы/programming_tasks/CodeForcesRound/927/c.cpp", "C++", 32, 0, 7, 4, 43
"/home/kapusta/Документы/programming_tasks/CodeForcesRound/927/c2.py", "Python", 0, 20, 0, 0, 20
"/home/kapusta/Документы/programming_tasks/CodeForcesRound/927/d.cpp", "C++", 48, 0, 0, 3, 51
"/home/kapusta/Документы/programming_tasks/CodeForcesRound/927/d2.cpp", "C++", 65, 0, 7, 2, 74
"/home/kapusta/Документы/programming_tasks/CodeForcesRound/927/d3.cpp", "C++", 35, 0, 0, 3, 38
"/home/kapusta/Документы/programming_tasks/CodeForcesRound/928/a.cpp", "C++", 23, 0, 0, 2, 25
"/home/kapusta/Документы/programming_tasks/CodeForcesRound/928/b.cpp", "C++", 31, 0, 1, 1, 33
"/home/kapusta/Документы/programming_tasks/CodeForcesRound/928/c.cpp", "C++", 48, 0, 68, 11, 127
"/home/kapusta/Документы/programming_tasks/CodeForcesRound/928/c2.cpp", "C++", 27, 0, 0, 3, 30
"/home/kapusta/Документы/programming_tasks/CodeForcesRound/960/a.cpp", "C++", 29, 0, 0, 1, 30
"/home/kapusta/Документы/programming_tasks/CodeForcesRound/960/b.cpp", "C++", 20, 0, 0, 1, 21
"/home/kapusta/Документы/programming_tasks/CodeForcesRound/960/c.cpp", "C++", 43, 0, 0, 1, 44
"/home/kapusta/Документы/programming_tasks/CodeForcesRound/960/c2.cpp", "C++", 36, 0, 2, 1, 39
"/home/kapusta/Документы/programming_tasks/CodeForcesRound/960/d.cpp", "C++", 159, 0, 1, 6, 166
"/home/kapusta/Документы/programming_tasks/CodeForcesRound/960/d2.cpp", "C++", 33, 0, 5, 1, 39
"/home/kapusta/Документы/programming_tasks/CodeForcesRound/960/e1.cpp", "C++", 13, 0, 0, 2, 15
"/home/kapusta/Документы/programming_tasks/CodeForcesRound/Beta2/a.cpp", "C++", 23, 0, 5, 1, 29
"/home/kapusta/Документы/programming_tasks/CodeForcesRound/Beta2/a2.cpp", "C++", 44, 0, 3, 1, 48
"/home/kapusta/Документы/programming_tasks/CodeForcesRound/Beta2/a3.cpp", "C++", 39, 0, 0, 2, 41
"/home/kapusta/Документы/programming_tasks/CodeForcesRound/Beta2/b.cpp", "C++", 64, 0, 2, 2, 68
"/home/kapusta/Документы/programming_tasks/CodeForcesRound/Beta2/b2.cpp", "C++", 64, 0, 1, 2, 67
"/home/kapusta/Документы/programming_tasks/CodeForcesRound/CodeForcesER/160/a.cpp", "C++", 30, 0, 0, 1, 31
"/home/kapusta/Документы/programming_tasks/CodeForcesRound/CodeForcesER/160/b.cpp", "C++", 17, 0, 0, 5, 22
"/home/kapusta/Документы/programming_tasks/CodeForcesRound/CodeForcesER/160/c.cpp", "C++", 41, 0, 13, 4, 58
"/home/kapusta/Документы/programming_tasks/CodeForcesRound/CodeForcesER/160/c2.cpp", "C++", 36, 0, 13, 4, 53
"/home/kapusta/Документы/programming_tasks/CodeForcesRound/CodeForcesER/160/d.cpp", "C++", 57, 0, 5, 6, 68
"/home/kapusta/Документы/programming_tasks/CodeForcesRound/CodeForcesER/161/a.cpp", "C++", 36, 0, 1, 1, 38
"/home/kapusta/Документы/programming_tasks/CodeForcesRound/CodeForcesER/161/b.cpp", "C++", 28, 0, 1, 1, 30
"/home/kapusta/Документы/programming_tasks/CodeForcesRound/CodeForcesER/161/b2.cpp", "C++", 29, 0, 0, 1, 30
"/home/kapusta/Документы/programming_tasks/CodeForcesRound/CodeForcesER/161/b3.cpp", "C++", 37, 0, 0, 2, 39
"/home/kapusta/Документы/programming_tasks/CodeForcesRound/CodeForcesER/161/c.cpp", "C++", 51, 0, 5, 1, 57
"/home/kapusta/Документы/programming_tasks/CodeForcesRound/CodeForcesER/162/a.cpp", "C++", 171, 0, 6, 27, 204
"/home/kapusta/Документы/programming_tasks/CodeForcesRound/GB2023/a.cpp", "C++", 32, 0, 0, 2, 34
"/home/kapusta/Документы/programming_tasks/CodeForcesRound/GB2023/b.cpp", "C++", 82, 0, 2, 4, 88
"/home/kapusta/Документы/programming_tasks/CodeForcesRound/GB2023/b2.cpp", "C++", 23, 0, 0, 2, 25
"/home/kapusta/Документы/programming_tasks/CodeForcesRound/GB2023/b3.cpp", "C++", 40, 0, 0, 3, 43
"/home/kapusta/Документы/programming_tasks/CodeForcesRound/GB2023/b4.cpp", "C++", 28, 0, 4, 2, 34
"/home/kapusta/Документы/programming_tasks/CodeForcesRound/H2024/a.cpp", "C++", 17, 0, 0, 1, 18
"/home/kapusta/Документы/programming_tasks/CodeForcesRound/H2024/b.cpp", "C++", 24, 0, 0, 1, 25
"/home/kapusta/Документы/programming_tasks/CodeForcesRound/H2024/c.cpp", "C++", 44, 0, 1, 1, 46
"/home/kapusta/Документы/programming_tasks/CodeForcesRound/H2024/c2.cpp", "C++", 16, 0, 0, 1, 17
"/home/kapusta/Документы/programming_tasks/CodeForcesRound/H2024/e.cpp", "C++", 42, 0, 2, 3, 47
"/home/kapusta/Документы/programming_tasks/CodeForcesRound/nar/1907A.cpp", "C++", 30, 0, 0, 1, 31
"/home/kapusta/Документы/programming_tasks/CodeForcesRound/nar/1909A.cpp", "C++", 41, 0, 0, 2, 43
"/home/kapusta/Документы/programming_tasks/CodeForcesRound/nar/1909A2.cpp", "C++", 37, 0, 0, 1, 38
"/home/kapusta/Документы/programming_tasks/CodeForcesRound/nar/1913A.cpp", "C++", 16, 0, 0, 2, 18
"/home/kapusta/Документы/programming_tasks/CodeForcesRound/nar/1920B.cpp", "C++", 32, 0, 6, 1, 39
"/home/kapusta/Документы/programming_tasks/CodeForcesRound/nar/1921C.cpp", "C++", 28, 0, 9, 1, 38
"/home/kapusta/Документы/programming_tasks/CodeForcesRound/nar/1922E.cpp", "C++", 14, 0, 0, 1, 15
"/home/kapusta/Документы/programming_tasks/CodeForcesRound/nar/31B.cpp", "C++", 12, 0, 0, 2, 14
"/home/kapusta/Документы/programming_tasks/CodeForcesRound/nar/48D.cpp", "C++", 51, 0, 6, 5, 62
"/home/kapusta/Документы/programming_tasks/CodeForcesRound/nar/74B.cpp", "C++", 22, 0, 1, 2, 25
"/home/kapusta/Документы/programming_tasks/CodeForcesRound/nar/91A.cpp", "C++", 38, 0, 0, 2, 40
"/home/kapusta/Документы/programming_tasks/CodeForcesRound/nar/91A2.cpp", "C++", 30, 0, 0, 1, 31
"/home/kapusta/Документы/programming_tasks/CodeForcesRound/nar/91A3_vlad.cpp", "C++", 16, 0, 0, 1, 17
"/home/kapusta/Документы/programming_tasks/CodeForcesRound/nar/VDA.cpp", "C++", 32, 0, 9, 1, 42
"/home/kapusta/Документы/programming_tasks/CodeForcesRound/nar/VDA2.cpp", "C++", 42, 0, 7, 1, 50
"/home/kapusta/Документы/programming_tasks/CodeForcesRound/nar/VDA3.cpp", "C++", 43, 0, 7, 1, 51
"/home/kapusta/Документы/programming_tasks/CodeForcesRound/nar/arbus.cpp", "C++", 13, 0, 0, 1, 14
"/home/kapusta/Документы/programming_tasks/CodeForcesRound/nar/brcube.cpp", "C++", 21, 0, 0, 1, 22
"/home/kapusta/Документы/programming_tasks/CodeForcesRound/nar/eltable.cpp", "C++", 59, 0, 2, 3, 64
"/home/kapusta/Документы/programming_tasks/CodeForcesRound/nar/fructs.cpp", "C++", 41, 0, 7, 1, 49
"/home/kapusta/Документы/programming_tasks/CodeForcesRound/nar/gameOfSumm.cpp", "C++", 37, 0, 0, 1, 38
"/home/kapusta/Документы/programming_tasks/CodeForcesRound/nar/gvosdiki.cpp", "C++", 21, 0, 6, 1, 28
"/home/kapusta/Документы/programming_tasks/CodeForcesRound/nar/king.cpp", "C++", 36, 0, 2, 1, 39
"/home/kapusta/Документы/programming_tasks/CodeForcesRound/nar/spell.cpp", "C++", 25, 0, 0, 2, 27
"/home/kapusta/Документы/programming_tasks/CodeForcesRound/nar/teatralPl.cpp", "C++", 12, 0, 0, 2, 14
"/home/kapusta/Документы/programming_tasks/CodeForcesRound/nar/vp.cpp", "C++", 35, 0, 2, 2, 39
"/home/kapusta/Документы/programming_tasks/CodeForcesRound/nar/vp2.cpp", "C++", 41, 0, 1, 2, 44
"/home/kapusta/Документы/programming_tasks/CodeForcesRound/nar/vp3.cpp", "C++", 40, 0, 7, 3, 50
"/home/kapusta/Документы/programming_tasks/DANO/a.cpp", "C++", 0, 0, 0, 1, 1
"/home/kapusta/Документы/programming_tasks/DANO/a.py", "Python", 0, 0, 0, 1, 1
"/home/kapusta/Документы/programming_tasks/Graphs/Deixtra/a.cpp", "C++", 47, 0, 0, 10, 57
"/home/kapusta/Документы/programming_tasks/Graphs/Deixtra/b.cpp", "C++", 54, 0, 1, 9, 64
"/home/kapusta/Документы/programming_tasks/Graphs/a.cpp", "C++", 14, 0, 0, 1, 15
"/home/kapusta/Документы/programming_tasks/Graphs/kirillSedow.cpp", "C++", 50, 0, 5, 1, 56
"/home/kapusta/Документы/programming_tasks/Graphs/love_triangle.cpp", "C++", 36, 0, 5, 2, 43
"/home/kapusta/Документы/programming_tasks/Graphs/ozera.cpp", "C++", 65, 0, 39, 5, 109
"/home/kapusta/Документы/programming_tasks/Graphs/rec_max.cpp", "C++", 11, 0, 1, 3, 15
"/home/kapusta/Документы/programming_tasks/ITMO/a.cpp", "C++", 39, 0, 5, 2, 46
"/home/kapusta/Документы/programming_tasks/ITMO/b.cpp", "C++", 67, 0, 7, 4, 78
"/home/kapusta/Документы/programming_tasks/ITMO/c.cpp", "C++", 12, 0, 0, 4, 16
"/home/kapusta/Документы/programming_tasks/ITMO/c.py", "Python", 0, 2, 0, 1, 3
"/home/kapusta/Документы/programming_tasks/ITMO/d.cpp", "C++", 72, 0, 4, 2, 78
"/home/kapusta/Документы/programming_tasks/ITMO/e.cpp", "C++", 107, 0, 7, 6, 120
"/home/kapusta/Документы/programming_tasks/MOS/a.cpp", "C++", 18, 0, 0, 2, 20
"/home/kapusta/Документы/programming_tasks/MOS/b.cpp", "C++", 40, 0, 1, 3, 44
"/home/kapusta/Документы/programming_tasks/MOS/c.cpp", "C++", 44, 0, 6, 2, 52
"/home/kapusta/Документы/programming_tasks/MOS/d.cpp", "C++", 60, 0, 31, 3, 94
"/home/kapusta/Документы/programming_tasks/MOS/d2.cpp", "C++", 52, 0, 20, 4, 76
"/home/kapusta/Документы/programming_tasks/MOS/d3.cpp", "C++", 50, 0, 23, 4, 77
"/home/kapusta/Документы/programming_tasks/MOS/d4.cpp", "C++", 43, 0, 0, 4, 47
"/home/kapusta/Документы/programming_tasks/MOS/d5.cpp", "C++", 43, 0, 0, 4, 47
"/home/kapusta/Документы/programming_tasks/MOS/d6.cpp", "C++", 61, 0, 9, 2, 72
"/home/kapusta/Документы/programming_tasks/MOS/e.cpp", "C++", 64, 0, 13, 9, 86
"/home/kapusta/Документы/programming_tasks/MOS/e2.cpp", "C++", 54, 0, 10, 5, 69
"/home/kapusta/Документы/programming_tasks/MOS/f.cpp", "C++", 26, 0, 13, 2, 41
"/home/kapusta/Документы/programming_tasks/MOS/f2.cpp", "C++", 33, 0, 12, 1, 46
"/home/kapusta/Документы/programming_tasks/MOS/f3.cpp", "C++", 12, 0, 0, 2, 14
"/home/kapusta/Документы/programming_tasks/REG/2013/a.cpp", "C++", 22, 0, 1, 2, 25
"/home/kapusta/Документы/programming_tasks/REG/2022/a.cpp", "C++", 42, 0, 16, 1, 59
"/home/kapusta/Документы/programming_tasks/REG/2022/b.cpp", "C++", 169, 0, 1, 7, 177
"/home/kapusta/Документы/programming_tasks/REG/2023/a.cpp", "C++", 37, 0, 1, 3, 41
"/home/kapusta/Документы/programming_tasks/REG/sbory/a.cpp", "C++", 38, 0, 0, 7, 45
"/home/kapusta/Документы/programming_tasks/SF/a.cpp", "C++", 27, 0, 0, 1, 28
"/home/kapusta/Документы/programming_tasks/SF/b.cpp", "C++", 50, 0, 0, 6, 56
"/home/kapusta/Документы/programming_tasks/SF/c.cpp", "C++", 124, 0, 21, 5, 150
"/home/kapusta/Документы/programming_tasks/SF/d.cpp", "C++", 37, 0, 0, 3, 40
"/home/kapusta/Документы/programming_tasks/SF/e.cpp", "C++", 25, 0, 0, 2, 27
"/home/kapusta/Документы/programming_tasks/SF/f.cpp", "C++", 50, 0, 12, 2, 64
"/home/kapusta/Документы/programming_tasks/Verchenko/test/a.cpp", "C++", 20, 0, 0, 3, 23
"/home/kapusta/Документы/programming_tasks/Verchenko/test/b.cpp", "C++", 19, 0, 0, 1, 20
"/home/kapusta/Документы/programming_tasks/Verchenko/test/c.cpp", "C++", 18, 0, 0, 2, 20
"/home/kapusta/Документы/programming_tasks/a.py", "Python", 0, 18, 0, 4, 22
"/home/kapusta/Документы/programming_tasks/acmp/a+b.cpp", "C++", 9, 0, 0, 1, 10
"/home/kapusta/Документы/programming_tasks/acmp/id0003.cpp", "C++", 9, 0, 0, 1, 10
"/home/kapusta/Документы/programming_tasks/acmp/id14.cpp", "C++", 19, 0, 0, 2, 21
"/home/kapusta/Документы/programming_tasks/acmp/id147.cpp", "C++", 15, 0, 0, 1, 16
"/home/kapusta/Документы/programming_tasks/acmp/id148.cpp", "C++", 20, 0, 0, 2, 22
"/home/kapusta/Документы/programming_tasks/acmp/id170.cpp", "C++", 29, 0, 2, 2, 33
"/home/kapusta/Документы/programming_tasks/acmp/id2.cpp", "C++", 19, 0, 0, 1, 20
"/home/kapusta/Документы/programming_tasks/acmp/id23.cpp", "C++", 14, 0, 0, 1, 15
"/home/kapusta/Документы/programming_tasks/acmp/id250.cpp", "C++", 33, 0, 0, 2, 35
"/home/kapusta/Документы/programming_tasks/acmp/id271.cpp", "C++", 33, 0, 1, 2, 36
"/home/kapusta/Документы/programming_tasks/acmp/id274.cpp", "C++", 34, 0, 0, 2, 36
"/home/kapusta/Документы/programming_tasks/acmp/id296.cpp", "C++", 19, 0, 0, 1, 20
"/home/kapusta/Документы/programming_tasks/acmp/id318.cpp", "C++", 16, 0, 0, 1, 17
"/home/kapusta/Документы/programming_tasks/acmp/id318n2.cpp", "C++", 26, 0, 1, 1, 28
"/home/kapusta/Документы/programming_tasks/acmp/id323.cpp", "C++", 26, 0, 2, 3, 31
"/home/kapusta/Документы/programming_tasks/acmp/id327.cpp", "C++", 26, 0, 0, 2, 28
"/home/kapusta/Документы/programming_tasks/acmp/id357.cpp", "C++", 22, 0, 0, 1, 23
"/home/kapusta/Документы/programming_tasks/acmp/id457.cpp", "C++", 30, 0, 0, 2, 32
"/home/kapusta/Документы/programming_tasks/acmp/id51.cpp", "C++", 14, 0, 0, 1, 15
"/home/kapusta/Документы/programming_tasks/acmp/id52.cpp", "C++", 17, 0, 0, 1, 18
"/home/kapusta/Документы/programming_tasks/acmp/id526.cpp", "C++", 42, 0, 2, 2, 46
"/home/kapusta/Документы/programming_tasks/acmp/id576.cpp", "C++", 26, 0, 0, 2, 28
"/home/kapusta/Документы/programming_tasks/acmp/id577.cpp", "C++", 23, 0, 0, 3, 26
"/home/kapusta/Документы/programming_tasks/acmp/id664.cpp", "C++", 12, 0, 0, 2, 14
"/home/kapusta/Документы/programming_tasks/acmp/id785.cpp", "C++", 25, 0, 1, 2, 28
"/home/kapusta/Документы/programming_tasks/acmp/id79.cpp", "C++", 13, 0, 0, 1, 14
"/home/kapusta/Документы/programming_tasks/acmp/id792.cpp", "C++", 22, 0, 0, 2, 24
"/home/kapusta/Документы/programming_tasks/acmp/id842.cpp", "C++", 19, 0, 0, 2, 21
"/home/kapusta/Документы/programming_tasks/acmp/negl.cpp", "C++", 8, 0, 0, 1, 9
"/home/kapusta/Документы/programming_tasks/ariphmetic/evklid.py", "Python", 0, 10, 0, 2, 12
"/home/kapusta/Документы/programming_tasks/ariphmetic/rasloj_na_prime.py", "Python", 0, 18, 0, 1, 19
"/home/kapusta/Документы/programming_tasks/ariphmetic/sum_drob.py", "Python", 0, 8, 0, 4, 12
"/home/kapusta/Документы/programming_tasks/belchonok/a.cpp", "C++", 23, 0, 1, 2, 26
"/home/kapusta/Документы/programming_tasks/belchonok/a.py", "Python", 0, 16, 0, 1, 17
"/home/kapusta/Документы/programming_tasks/belchonok/b.cpp", "C++", 41, 0, 1, 3, 45
"/home/kapusta/Документы/programming_tasks/cappa/min.py", "Python", 0, 92, 3, 5, 100
"/home/kapusta/Документы/programming_tasks/cappa/min2.py", "Python", 0, 9, 0, 2, 11
"/home/kapusta/Документы/programming_tasks/dynamic/banck.py", "Python", 0, 18, 0, 2, 20
"/home/kapusta/Документы/programming_tasks/dynamic/calculator.py", "Python", 0, 23, 0, 1, 24
"/home/kapusta/Документы/programming_tasks/dynamic/checker.py", "Python", 0, 13, 0, 1, 14
"/home/kapusta/Документы/programming_tasks/dynamic/fib1.cpp", "C++", 0, 0, 0, 1, 1
"/home/kapusta/Документы/programming_tasks/dynamic/fib1.py", "Python", 0, 7, 0, 2, 9
"/home/kapusta/Документы/programming_tasks/dynamic/fib2.py", "Python", 0, 6, 0, 4, 10
"/home/kapusta/Документы/programming_tasks/dynamic/gvozdi.py", "Python", 0, 16, 2, 5, 23
"/home/kapusta/Документы/programming_tasks/dynamic/hitr_posl.py", "Python", 0, 11, 0, 2, 13
"/home/kapusta/Документы/programming_tasks/dynamic/hpf.py", "Python", 0, 9, 1, 2, 12
"/home/kapusta/Документы/programming_tasks/dynamic/kus2.py", "Python", 0, 6, 0, 3, 9
"/home/kapusta/Документы/programming_tasks/dynamic/kus3.py", "Python", 0, 10, 1, 3, 14
"/home/kapusta/Документы/programming_tasks/dynamic/kus4.py", "Python", 0, 9, 1, 3, 13
"/home/kapusta/Документы/programming_tasks/dynamic/kus5.py", "Python", 0, 11, 1, 3, 15
"/home/kapusta/Документы/programming_tasks/dynamic/kus6.py", "Python", 0, 10, 2, 3, 15
"/home/kapusta/Документы/programming_tasks/dynamic/kusnechik.py", "Python", 0, 6, 0, 3, 9
"/home/kapusta/Документы/programming_tasks/dynamic/lcs.py", "Python", 0, 16, 1, 1, 18
"/home/kapusta/Документы/programming_tasks/dynamic/lcsd.py", "Python", 0, 20, 0, 2, 22
"/home/kapusta/Документы/programming_tasks/dynamic/othodi2.py", "Python", 0, 14, 0, 2, 16
"/home/kapusta/Документы/programming_tasks/dynamic/pascal_tr.py", "Python", 0, 15, 0, 0, 15
"/home/kapusta/Документы/programming_tasks/dynamic/rukzak.py", "Python", 0, 13, 0, 2, 15
"/home/kapusta/Документы/programming_tasks/dynamic/sum_cubes.cpp", "C++", 27, 0, 1, 2, 30
"/home/kapusta/Документы/programming_tasks/dynamic/sum_cubes.py", "Python", 0, 17, 0, 4, 21
"/home/kapusta/Документы/programming_tasks/dynamic/sum_cubesD.py", "Python", 0, 9, 0, 2, 11
"/home/kapusta/Документы/programming_tasks/dynamic/tribonachchi.py", "Python", 0, 8, 0, 3, 11
"/home/kapusta/Документы/programming_tasks/dynamic/zero_one.py", "Python", 0, 15, 1, 2, 18
"/home/kapusta/Документы/programming_tasks/informatics/1.cpp", "C++", 21, 0, 0, 1, 22
"/home/kapusta/Документы/programming_tasks/informatics/another_game.cpp", "C++", 10, 0, 0, 5, 15
"/home/kapusta/Документы/programming_tasks/informatics/app_bin_search.cpp", "C++", 8, 0, 0, 1, 9
"/home/kapusta/Документы/programming_tasks/informatics/approximate_bin_search.cpp", "C++", 29, 0, 0, 1, 30
"/home/kapusta/Документы/programming_tasks/informatics/bin_search.cpp", "C++", 33, 0, 1, 1, 35
"/home/kapusta/Документы/programming_tasks/informatics/collums.cpp", "C++", 22, 0, 0, 1, 23
"/home/kapusta/Документы/programming_tasks/informatics/cows_in_stoils.py", "Python", 0, 27, 1, 3, 31
"/home/kapusta/Документы/programming_tasks/informatics/diplomi.cpp", "C++", 18, 0, 0, 1, 19
"/home/kapusta/Документы/programming_tasks/informatics/droids.cpp", "C++", 22, 0, 0, 1, 23
"/home/kapusta/Документы/programming_tasks/informatics/kontest.cpp", "C++", 46, 0, 0, 4, 50
"/home/kapusta/Документы/programming_tasks/informatics/matrix.py", "Python", 0, 10, 0, 1, 11
"/home/kapusta/Документы/programming_tasks/informatics/max_on_start.cpp", "C++", 23, 0, 0, 2, 25
"/home/kapusta/Документы/programming_tasks/informatics/max_on_start.py", "Python", 0, 2, 0, 2, 4
"/home/kapusta/Документы/programming_tasks/innopolisOpen/first_tour/a.cpp", "C++", 33, 0, 1, 1, 35
"/home/kapusta/Документы/programming_tasks/innopolisOpen/first_tour/a2.cpp", "C++", 41, 0, 0, 1, 42
"/home/kapusta/Документы/programming_tasks/innopolisOpen/first_tour/b.cpp", "C++", 31, 0, 9, 4, 44
"/home/kapusta/Документы/programming_tasks/innopolisOpen/first_tour/b2.cpp", "C++", 39, 0, 0, 3, 42
"/home/kapusta/Документы/programming_tasks/innopolisOpen/first_tour/base.cpp", "C++", 10, 0, 0, 2, 12
"/home/kapusta/Документы/programming_tasks/innopolisOpen/first_tour/c.cpp", "C++", 57, 0, 1, 2, 60
"/home/kapusta/Документы/programming_tasks/innopolisOpen/first_tour/d.cpp", "C++", 10, 0, 0, 2, 12
"/home/kapusta/Документы/programming_tasks/innopolisOpen/first_tour/e.cpp", "C++", 10, 0, 0, 2, 12
"/home/kapusta/Документы/programming_tasks/innopolisOpen/test_tour/a.cpp", "C++", 9, 0, 0, 1, 10
"/home/kapusta/Документы/programming_tasks/innopolisOpen/test_tour/a.py", "Python", 0, 3, 0, 0, 3
"/home/kapusta/Документы/programming_tasks/innopolisOpen/test_tour/b.cpp", "C++", 17, 0, 0, 1, 18
"/home/kapusta/Документы/programming_tasks/innopolisOpen/test_tour/b.py", "Python", 0, 2, 0, 1, 3
"/home/kapusta/Документы/programming_tasks/innopolisOpen/test_tour/c.cpp", "C++", 17, 0, 0, 1, 18
"/home/kapusta/Документы/programming_tasks/innopolisOpen/test_tour/d.cpp", "C++", 43, 0, 2, 5, 50
"/home/kapusta/Документы/programming_tasks/innopolisOpen/test_tour/e.cpp", "C++", 28, 0, 1, 3, 32
"/home/kapusta/Документы/programming_tasks/izumrud/a.cpp", "C++", 11, 0, 0, 1, 12
"/home/kapusta/Документы/programming_tasks/izumrud/b.cpp", "C++", 20, 0, 0, 2, 22
"/home/kapusta/Документы/programming_tasks/izumrud/c.cpp", "C++", 24, 0, 0, 3, 27
"/home/kapusta/Документы/programming_tasks/izumrud/d.cpp", "C++", 26, 0, 0, 3, 29
"/home/kapusta/Документы/programming_tasks/izumrud/e.cpp", "C++", 34, 0, 2, 3, 39
"/home/kapusta/Документы/programming_tasks/lomonosov/a.cpp", "C++", 82, 0, 3, 6, 91
"/home/kapusta/Документы/programming_tasks/lomonosov/b.cpp", "C++", 49, 0, 4, 1, 54
"/home/kapusta/Документы/programming_tasks/lomonosov/c.cpp", "C++", 30, 0, 0, 1, 31
"/home/kapusta/Документы/programming_tasks/lomonosov/e.cpp", "C++", 92, 0, 15, 11, 118
"/home/kapusta/Документы/programming_tasks/lomonosov/hello.cpp", "C++", 5, 0, 0, 1, 6
"/home/kapusta/Документы/programming_tasks/myContest/testCon/a.cpp", "C++", 20, 0, 0, 1, 21
"/home/kapusta/Документы/programming_tasks/myContest/testCon/a2.cpp", "C++", 5, 0, 0, 1, 6
"/home/kapusta/Документы/programming_tasks/myContest/testCon/c.cpp", "C++", 45, 0, 0, 3, 48
"/home/kapusta/Документы/programming_tasks/myContest/testCon/testerA.py", "Python", 0, 3, 0, 3, 6
"/home/kapusta/Документы/programming_tasks/otbor_tinkof080923/blocks.cpp", "C++", 35, 0, 0, 3, 38
"/home/kapusta/Документы/programming_tasks/otbor_tinkof080923/blocks.py", "Python", 0, 14, 0, 2, 16
"/home/kapusta/Документы/programming_tasks/otbor_tinkof080923/ciferblat.py", "Python", 0, 9, 0, 3, 12
"/home/kapusta/Документы/programming_tasks/otbor_tinkof080923/derijabl.cpp", "C++", 15, 0, 0, 2, 17
"/home/kapusta/Документы/programming_tasks/otbor_tinkof080923/derijable.py", "Python", 0, 39, 1, 2, 42
"/home/kapusta/Документы/programming_tasks/otbor_tinkof080923/expedition.cpp", "C++", 32, 0, 0, 1, 33
"/home/kapusta/Документы/programming_tasks/otbor_tinkof080923/fast_div_ost.cpp", "C++", 6, 0, 0, 1, 7
"/home/kapusta/Документы/programming_tasks/otbor_tinkof080923/haker_vitalii.cpp", "C++", 23, 0, 0, 2, 25
"/home/kapusta/Документы/programming_tasks/otbor_tinkof080923/last_blocks.cpp", "C++", 34, 0, 0, 3, 37
"/home/kapusta/Документы/programming_tasks/otbor_tinkof080923/left_right_bin_search.cpp", "C++", 38, 0, 1, 1, 40
"/home/kapusta/Документы/programming_tasks/otbor_tinkof080923/line_search.cpp", "C++", 22, 0, 0, 1, 23
"/home/kapusta/Документы/programming_tasks/otbor_tinkof080923/max_elemant.cpp", "C++", 14, 0, 0, 1, 15
"/home/kapusta/Документы/programming_tasks/otbor_tinkof080923/minus.py", "Python", 0, 2, 0, 1, 3
"/home/kapusta/Документы/programming_tasks/otbor_tinkof080923/minus2.py", "Python", 0, 15, 0, 3, 18
"/home/kapusta/Документы/programming_tasks/otbor_tinkof080923/next_number.cpp", "C++", 18, 0, 0, 1, 19
"/home/kapusta/Документы/programming_tasks/otbor_tinkof080923/otrezki.cpp", "C++", 76, 0, 13, 8, 97
"/home/kapusta/Документы/programming_tasks/otbor_tinkof080923/otrezki.py", "Python", 0, 63, 2, 13, 78
"/home/kapusta/Документы/programming_tasks/otbor_tinkof080923/polindrome.py", "Python", 0, 22, 3, 5, 30
"/home/kapusta/Документы/programming_tasks/otbor_tinkof080923/polindromes.cpp", "C++", 66, 0, 0, 5, 71
"/home/kapusta/Документы/programming_tasks/otbor_tinkof080923/pr.cpp", "C++", 56, 0, 0, 5, 61
"/home/kapusta/Документы/programming_tasks/otbor_tinkof080923/prazdn.py", "Python", 0, 6, 0, 5, 11
"/home/kapusta/Документы/programming_tasks/otbor_tinkof080923/rgb.py", "Python", 0, 13, 0, 3, 16
"/home/kapusta/Документы/programming_tasks/otbor_tinkof080923/rojer.cpp", "C++", 21, 0, 3, 4, 28
"/home/kapusta/Документы/programming_tasks/otbor_tinkof080923/sedlov_point.cpp", "C++", 45, 0, 0, 1, 46
"/home/kapusta/Документы/programming_tasks/otbor_tinkof080923/serebr_medal.cpp", "C++", 23, 0, 0, 1, 24
"/home/kapusta/Документы/programming_tasks/otbor_tinkof080923/simple_rojer.cpp", "C++", 11, 0, 1, 3, 15
"/home/kapusta/Документы/programming_tasks/otbor_tinkof080923/sort.cpp", "C++", 18, 0, 0, 2, 20
"/home/kapusta/Документы/programming_tasks/otbor_tinkof080923/very_lite_qwestion.cpp", "C++", 4, 0, 0, 2, 6
"/home/kapusta/Документы/programming_tasks/otbor_tinkof080923/very_lite_qwestion.py", "Python", 0, 10, 0, 0, 10
"/home/kapusta/Документы/programming_tasks/otbor_tinkof080923/ybiley.py", "Python", 0, 1, 0, 2, 3
"/home/kapusta/Документы/programming_tasks/otbor_tinkoff02/a.cpp", "C++", 23, 0, 0, 3, 26
"/home/kapusta/Документы/programming_tasks/otbor_tinkoff02/at.cpp", "C++", 20, 0, 0, 2, 22
"/home/kapusta/Документы/programming_tasks/technoCup/a.cpp", "C++", 18, 0, 0, 2, 20
"/home/kapusta/Документы/programming_tasks/technoCup/b.cpp", "C++", 22, 0, 0, 2, 24
"/home/kapusta/Документы/programming_tasks/technoCup/test.py", "Python", 0, 5, 0, 2, 7
"/home/kapusta/Документы/programming_tasks/timus/id1820.cpp", "C++", 9, 0, 0, 1, 10
"/home/kapusta/Документы/programming_tasks/tinkoff/BFS&D/a.cpp", "C++", 41, 0, 1, 7, 49
"/home/kapusta/Документы/programming_tasks/tinkoff/BFS&D/a2.cpp", "C++", 44, 0, 1, 7, 52
"/home/kapusta/Документы/programming_tasks/tinkoff/BFS&D/b.cpp", "C++", 34, 0, 0, 8, 42
"/home/kapusta/Документы/programming_tasks/tinkoff/BFS&D/c.cpp", "C++", 57, 0, 15, 8, 80
"/home/kapusta/Документы/programming_tasks/tinkoff/BFS&D/d.cpp", "C++", 63, 0, 13, 11, 87
"/home/kapusta/Документы/programming_tasks/tinkoff/BFS&D/d2.cpp", "C++", 51, 0, 13, 11, 75
"/home/kapusta/Документы/programming_tasks/tinkoff/BFS&D/d3.cpp", "C++", 50, 0, 10, 13, 73
"/home/kapusta/Документы/programming_tasks/tinkoff/BFS&D/d4.cpp", "C++", 52, 0, 5, 7, 64
"/home/kapusta/Документы/programming_tasks/tinkoff/BFS&D/e.cpp", "C++", 63, 0, 3, 13, 79
"/home/kapusta/Документы/programming_tasks/tinkoff/BFS&D/e2.cpp", "C++", 53, 0, 1, 10, 64
"/home/kapusta/Документы/programming_tasks/tinkoff/BFS&D/e3.cpp", "C++", 55, 0, 10, 6, 71
"/home/kapusta/Документы/programming_tasks/tinkoff/BFS&D/f.cpp", "C++", 69, 0, 0, 6, 75
"/home/kapusta/Документы/programming_tasks/tinkoff/BFS&D/g.cpp", "C++", 53, 0, 7, 8, 68
"/home/kapusta/Документы/programming_tasks/tinkoff/BFS&D/h.cpp", "C++", 72, 0, 6, 7, 85
"/home/kapusta/Документы/programming_tasks/tinkoff/BFS&D/i.cpp", "C++", 87, 0, 13, 11, 111
"/home/kapusta/Документы/programming_tasks/tinkoff/BFS&D/j.cpp", "C++", 48, 0, 1, 9, 58
"/home/kapusta/Документы/programming_tasks/tinkoff/BFS&D/j2.cpp", "C++", 49, 0, 1, 8, 58
"/home/kapusta/Документы/programming_tasks/tinkoff/BFS&D/j3.cpp", "C++", 43, 0, 3, 6, 52
"/home/kapusta/Документы/programming_tasks/tinkoff/BFS&D/j4.cpp", "C++", 58, 0, 2, 11, 71
"/home/kapusta/Документы/programming_tasks/tinkoff/BFS&D/j5.cpp", "C++", 70, 0, 6, 8, 84
"/home/kapusta/Документы/programming_tasks/tinkoff/BFS&D/j6.cpp", "C++", 63, 0, 2, 7, 72
"/home/kapusta/Документы/programming_tasks/tinkoff/BFS&D/k.cpp", "C++", 56, 0, 6, 12, 74
"/home/kapusta/Документы/programming_tasks/tinkoff/BFS&D/l.cpp", "C++", 111, 0, 17, 9, 137
"/home/kapusta/Документы/programming_tasks/tinkoff/BFS&D/m.cpp", "C++", 86, 0, 19, 5, 110
"/home/kapusta/Документы/programming_tasks/tinkoff/BFS&D/m2.cpp", "C++", 74, 0, 6, 7, 87
"/home/kapusta/Документы/programming_tasks/tinkoff/BFS&D/n.cpp", "C++", 51, 0, 5, 3, 59
"/home/kapusta/Документы/programming_tasks/tinkoff/BFS&D/n2.cpp", "C++", 48, 0, 2, 7, 57
"/home/kapusta/Документы/programming_tasks/tinkoff/BFS&D/o.cpp", "C++", 59, 0, 4, 12, 75
"/home/kapusta/Документы/programming_tasks/tinkoff/BFS&D/o2.cpp", "C++", 21, 0, 0, 3, 24
"/home/kapusta/Документы/programming_tasks/tinkoff/DFS/a.cpp", "C++", 21, 0, 0, 1, 22
"/home/kapusta/Документы/programming_tasks/tinkoff/DFS/b.cpp", "C++", 21, 0, 0, 1, 22
"/home/kapusta/Документы/programming_tasks/tinkoff/DFS/c.cpp", "C++", 39, 0, 3, 3, 45
"/home/kapusta/Документы/programming_tasks/tinkoff/DFS/d.cpp", "C++", 38, 0, 13, 3, 54
"/home/kapusta/Документы/programming_tasks/tinkoff/DFS/d2.cpp", "C++", 38, 0, 3, 4, 45
"/home/kapusta/Документы/programming_tasks/tinkoff/DFS/d3.cpp", "C++", 39, 0, 2, 4, 45
"/home/kapusta/Документы/programming_tasks/tinkoff/DFS/e.cpp", "C++", 46, 0, 0, 3, 49
"/home/kapusta/Документы/programming_tasks/tinkoff/DFS/f.cpp", "C++", 36, 0, 0, 5, 41
"/home/kapusta/Документы/programming_tasks/tinkoff/DFS/g.cpp", "C++", 35, 0, 1, 3, 39
"/home/kapusta/Документы/programming_tasks/tinkoff/DFS/h.cpp", "C++", 40, 0, 5, 3, 48
"/home/kapusta/Документы/programming_tasks/tinkoff/DFS/i.cpp", "C++", 42, 0, 7, 5, 54
"/home/kapusta/Документы/programming_tasks/tinkoff/DFS/j.cpp", "C++", 33, 0, 0, 6, 39
"/home/kapusta/Документы/programming_tasks/tinkoff/DFS/j2.cpp", "C++", 46, 0, 0, 4, 50
"/home/kapusta/Документы/programming_tasks/tinkoff/DFS/j3.cpp", "C++", 46, 0, 3, 5, 54
"/home/kapusta/Документы/programming_tasks/tinkoff/DFS/k.cpp", "C++", 33, 0, 3, 3, 39
"/home/kapusta/Документы/programming_tasks/tinkoff/DFS/k2.cpp", "C++", 34, 0, 0, 7, 41
"/home/kapusta/Документы/programming_tasks/tinkoff/DFS/l.cpp", "C++", 39, 0, 8, 3, 50
"/home/kapusta/Документы/programming_tasks/tinkoff/DFS/m.cpp", "C++", 42, 0, 0, 9, 51
"/home/kapusta/Документы/programming_tasks/tinkoff/DFS/n.cpp", "C++", 31, 0, 9, 11, 51
"/home/kapusta/Документы/programming_tasks/tinkoff/DFS/n2.cpp", "C++", 42, 0, 3, 10, 55
"/home/kapusta/Документы/programming_tasks/tinkoff/DFS/o.cpp", "C++", 47, 0, 0, 6, 53
"/home/kapusta/Документы/programming_tasks/tinkoff/DFS/p.cpp", "C++", 41, 0, 0, 7, 48
"/home/kapusta/Документы/programming_tasks/tinkoff/F&FB/a.cpp", "C++", 43, 0, 0, 7, 50
"/home/kapusta/Документы/programming_tasks/tinkoff/F&FB/a2.cpp", "C++", 44, 0, 2, 8, 54
"/home/kapusta/Документы/programming_tasks/tinkoff/F&FB/b.cpp", "C++", 65, 0, 0, 9, 74
"/home/kapusta/Документы/programming_tasks/tinkoff/F&FB/b2.cpp", "C++", 59, 0, 0, 11, 70
"/home/kapusta/Документы/programming_tasks/tinkoff/STL/a.cpp", "C++", 27, 0, 0, 1, 28
"/home/kapusta/Документы/programming_tasks/tinkoff/STL/bl.cpp", "C++", 36, 0, 0, 1, 37
"/home/kapusta/Документы/programming_tasks/tinkoff/STL/c.cpp", "C++", 19, 0, 0, 1, 20
"/home/kapusta/Документы/programming_tasks/tinkoff/STL/d.cpp", "C++", 36, 0, 0, 1, 37
"/home/kapusta/Документы/programming_tasks/tinkoff/STL/f.cpp", "C++", 47, 0, 15, 3, 65
"/home/kapusta/Документы/programming_tasks/tinkoff/binsearch/a.cpp", "C++", 32, 0, 0, 3, 35
"/home/kapusta/Документы/programming_tasks/tinkoff/binsearch/a.py", "Python", 0, 14, 0, 3, 17
"/home/kapusta/Документы/programming_tasks/tinkoff/binsearch/b.cpp", "C++", 30, 0, 0, 3, 33
"/home/kapusta/Документы/programming_tasks/tinkoff/binsearch/bl.cpp", "C++", 26, 0, 0, 1, 27
"/home/kapusta/Документы/programming_tasks/tinkoff/binsearch/cl.cpp", "C++", 47, 0, 0, 2, 49
"/home/kapusta/Документы/programming_tasks/tinkoff/binsearch/d.cpp", "C++", 20, 0, 0, 3, 23
"/home/kapusta/Документы/programming_tasks/tinkoff/binsearch/e.cpp", "C++", 23, 0, 0, 1, 24
"/home/kapusta/Документы/programming_tasks/tinkoff/binsearch/f.cpp", "C++", 19, 0, 0, 3, 22
"/home/kapusta/Документы/programming_tasks/tinkoff/binsearch/g.cpp", "C++", 32, 0, 9, 2, 43
"/home/kapusta/Документы/programming_tasks/tinkoff/binsearch/h.cpp", "C++", 34, 0, 6, 3, 43
"/home/kapusta/Документы/programming_tasks/tinkoff/binsearch/hl.cpp", "C++", 28, 0, 0, 3, 31
"/home/kapusta/Документы/programming_tasks/tinkoff/binsearch/i.cpp", "C++", 19, 0, 0, 4, 23
"/home/kapusta/Документы/programming_tasks/tinkoff/binsearch/j.cpp", "C++", 25, 0, 0, 5, 30
"/home/kapusta/Документы/programming_tasks/tinkoff/binsearch/jl.cpp", "C++", 30, 0, 1, 3, 34
"/home/kapusta/Документы/programming_tasks/tinkoff/binsearch/kl.cpp", "C++", 37, 0, 2, 5, 44
"/home/kapusta/Документы/programming_tasks/tinkoff/dynamic/a.cpp", "C++", 20, 0, 0, 3, 23
"/home/kapusta/Документы/programming_tasks/tinkoff/dynamic/a2.cpp", "C++", 16, 0, 0, 1, 17
"/home/kapusta/Документы/programming_tasks/tinkoff/dynamic/b.cpp", "C++", 17, 0, 0, 1, 18
"/home/kapusta/Документы/programming_tasks/tinkoff/dynamic/c.cpp", "C++", 20, 0, 0, 1, 21
"/home/kapusta/Документы/programming_tasks/tinkoff/dynamic/c2.cpp", "C++", 19, 0, 0, 1, 20
"/home/kapusta/Документы/programming_tasks/tinkoff/dynamic/d.cpp", "C++", 37, 0, 9, 1, 47
"/home/kapusta/Документы/programming_tasks/tinkoff/dynamic/d2.cpp", "C++", 40, 0, 0, 2, 42
"/home/kapusta/Документы/programming_tasks/tinkoff/dynamic/d3.cpp", "C++", 50, 0, 2, 1, 53
"/home/kapusta/Документы/programming_tasks/tinkoff/dynamic/d4.cpp", "C++", 48, 0, 0, 1, 49
"/home/kapusta/Документы/programming_tasks/tinkoff/dynamic/e.cpp", "C++", 19, 0, 0, 1, 20
"/home/kapusta/Документы/programming_tasks/tinkoff/dynamic/f.cpp", "C++", 27, 0, 0, 1, 28
"/home/kapusta/Документы/programming_tasks/tinkoff/dynamic/g.cpp", "C++", 17, 0, 0, 1, 18
"/home/kapusta/Документы/programming_tasks/tinkoff/dynamic/h.cpp", "C++", 33, 0, 0, 2, 35
"/home/kapusta/Документы/programming_tasks/tinkoff/dynamic/h2.cpp", "C++", 31, 0, 0, 1, 32
"/home/kapusta/Документы/programming_tasks/tinkoff/dynamic/h3.cpp", "C++", 24, 0, 0, 1, 25
"/home/kapusta/Документы/programming_tasks/tinkoff/dynamic/i.cpp", "C++", 17, 0, 0, 1, 18
"/home/kapusta/Документы/programming_tasks/tinkoff/dynamic/i2.cpp", "C++", 17, 0, 0, 1, 18
"/home/kapusta/Документы/programming_tasks/tinkoff/dynamic/j.cpp", "C++", 24, 0, 0, 1, 25
"/home/kapusta/Документы/programming_tasks/tinkoff/dynamic/j2.cpp", "C++", 22, 0, 0, 1, 23
"/home/kapusta/Документы/programming_tasks/tinkoff/dynamic/j3.cpp", "C++", 70, 0, 18, 3, 91
"/home/kapusta/Документы/programming_tasks/tinkoff/dynamic/j4.cpp", "C++", 43, 0, 17, 1, 61
"/home/kapusta/Документы/programming_tasks/tinkoff/dynamic/j5.cpp", "C++", 60, 0, 31, 1, 92
"/home/kapusta/Документы/programming_tasks/tinkoff/dynamic/j6.cpp", "C++", 2, 0, 0, 1, 3
"/home/kapusta/Документы/programming_tasks/tinkoff/dynamic/k.cpp", "C++", 33, 0, 3, 1, 37
"/home/kapusta/Документы/programming_tasks/tinkoff/dynamic/k2.cpp", "C++", 21, 0, 0, 1, 22
"/home/kapusta/Документы/programming_tasks/tinkoff/dynamic/l.cpp", "C++", 26, 0, 0, 1, 27
"/home/kapusta/Документы/programming_tasks/tinkoff/dynamic/m.cpp", "C++", 33, 0, 0, 1, 34
"/home/kapusta/Документы/programming_tasks/tinkoff/dynamic/n.cpp", "C++", 25, 0, 0, 1, 26
"/home/kapusta/Документы/programming_tasks/tinkoff/dynamic/o.cpp", "C++", 26, 0, 0, 1, 27
"/home/kapusta/Документы/programming_tasks/tinkoff/dynamic/p.cpp", "C++", 42, 0, 0, 1, 43
"/home/kapusta/Документы/programming_tasks/tinkoff/dynamic/q.cpp", "C++", 20, 0, 0, 1, 21
"/home/kapusta/Документы/programming_tasks/tinkoff/dynamic2/a.cpp", "C++", 27, 0, 0, 1, 28
"/home/kapusta/Документы/programming_tasks/tinkoff/dynamic2/a.py", "Python", 0, 9, 0, 3, 12
"/home/kapusta/Документы/programming_tasks/tinkoff/dynamic2/b.cpp", "C++", 35, 0, 0, 1, 36
"/home/kapusta/Документы/programming_tasks/tinkoff/dynamic2/c.cpp", "C++", 28, 0, 0, 1, 29
"/home/kapusta/Документы/programming_tasks/tinkoff/dynamic2/d.cpp", "C++", 41, 0, 5, 2, 48
"/home/kapusta/Документы/programming_tasks/tinkoff/dynamic2/d2.cpp", "C++", 32, 0, 8, 2, 42
"/home/kapusta/Документы/programming_tasks/tinkoff/dynamic2/d3.cpp", "C++", 19, 0, 0, 1, 20
"/home/kapusta/Документы/programming_tasks/tinkoff/dynamic2/d4.cpp", "C++", 29, 0, 0, 1, 30
"/home/kapusta/Документы/programming_tasks/tinkoff/dynamic2/e.cpp", "C++", 41, 0, 6, 1, 48
"/home/kapusta/Документы/programming_tasks/tinkoff/dynamic2/e2.cpp", "C++", 44, 0, 0, 1, 45
"/home/kapusta/Документы/programming_tasks/tinkoff/dynamic2/f.cpp", "C++", 42, 0, 3, 1, 46
"/home/kapusta/Документы/programming_tasks/tinkoff/dynamic2/f2.cpp", "C++", 37, 0, 0, 1, 38
"/home/kapusta/Документы/programming_tasks/tinkoff/dynamic2/g.cpp", "C++", 46, 0, 0, 1, 47
"/home/kapusta/Документы/programming_tasks/tinkoff/dynamic2/h.cpp", "C++", 26, 0, 0, 1, 27
"/home/kapusta/Документы/programming_tasks/tinkoff/dynamic2/i.cpp", "C++", 22, 0, 0, 1, 23
"/home/kapusta/Документы/programming_tasks/tinkoff/dynamic2/j.cpp", "C++", 35, 0, 5, 1, 41
"/home/kapusta/Документы/programming_tasks/tinkoff/dynamic2/j2.cpp", "C++", 51, 0, 10, 4, 65
"/home/kapusta/Документы/programming_tasks/tinkoff/dynamic2/j3.cpp", "C++", 80, 0, 3, 3, 86
"/home/kapusta/Документы/programming_tasks/tinkoff/dynamic2/j4.cpp", "C++", 55, 0, 4, 2, 61
"/home/kapusta/Документы/programming_tasks/tinkoff/dynamic2/j5.cpp", "C++", 55, 0, 6, 1, 62
"/home/kapusta/Документы/programming_tasks/tinkoff/dynamic2/j6.cpp", "C++", 57, 0, 5, 1, 63
"/home/kapusta/Документы/programming_tasks/tinkoff/dynamic2/k.cpp", "C++", 36, 0, 0, 1, 37
"/home/kapusta/Документы/programming_tasks/tinkoff/dynamic2/l.cpp", "C++", 25, 0, 2, 1, 28
"/home/kapusta/Документы/programming_tasks/tinkoff/dynamic2/l2.cpp", "C++", 30, 0, 2, 1, 33
"/home/kapusta/Документы/programming_tasks/tinkoff/dynamic2/l3.cpp", "C++", 32, 0, 0, 1, 33
"/home/kapusta/Документы/programming_tasks/tinkoff/dynamic2/l4.cpp", "C++", 38, 0, 0, 2, 40
"/home/kapusta/Документы/programming_tasks/tinkoff/dynamic2/l5.cpp", "C++", 42, 0, 2, 2, 46
"/home/kapusta/Документы/programming_tasks/tinkoff/dynamic2/m.cpp", "C++", 27, 0, 0, 1, 28
"/home/kapusta/Документы/programming_tasks/tinkoff/dynamic2/n.cpp", "C++", 35, 0, 0, 2, 37
"/home/kapusta/Документы/programming_tasks/tinkoff/dynamic2/n2.cpp", "C++", 39, 0, 1, 2, 42
"/home/kapusta/Документы/programming_tasks/tinkoff/dynamic2/n3.cpp", "C++", 32, 0, 1, 3, 36
"/home/kapusta/Документы/programming_tasks/tinkoff/dynamic2/n4.cpp", "C++", 16, 0, 0, 1, 17
"/home/kapusta/Документы/programming_tasks/tinkoff/dynamic2/q.cpp", "C++", 29, 0, 0, 1, 30
"/home/kapusta/Документы/programming_tasks/tinkoff/dynamic2/q2.cpp", "C++", 31, 0, 0, 1, 32
"/home/kapusta/Документы/programming_tasks/tinkoff/dynamic2/r.cpp", "C++", 32, 0, 3, 1, 36
"/home/kapusta/Документы/programming_tasks/tinkoff/dynamic2/r2.cpp", "C++", 41, 0, 0, 1, 42
"/home/kapusta/Документы/programming_tasks/tinkoff/exam/a.cpp", "C++", 21, 0, 0, 1, 22
"/home/kapusta/Документы/programming_tasks/tinkoff/exam/b.cpp", "C++", 17, 0, 0, 1, 18
"/home/kapusta/Документы/programming_tasks/tinkoff/exam/c.cpp", "C++", 22, 0, 0, 2, 24
"/home/kapusta/Документы/programming_tasks/tinkoff/exam/d.cpp", "C++", 57, 0, 16, 3, 76
"/home/kapusta/Документы/programming_tasks/tinkoff/exam/e.cpp", "C++", 22, 0, 1, 2, 25
"/home/kapusta/Документы/programming_tasks/tinkoff/exam/f.cpp", "C++", 34, 0, 0, 1, 35
"/home/kapusta/Документы/programming_tasks/tinkoff/exam/g.cpp", "C++", 83, 0, 10, 7, 100
"/home/kapusta/Документы/programming_tasks/tinkoff/exam/h.cpp", "C++", 29, 0, 4, 1, 34
"/home/kapusta/Документы/programming_tasks/tinkoff/exam/i.cpp", "C++", 32, 0, 0, 2, 34
"/home/kapusta/Документы/programming_tasks/tinkoff/exam/i2.cpp", "C++", 39, 0, 12, 5, 56
"/home/kapusta/Документы/programming_tasks/tinkoff/lin/a.cpp", "C++", 35, 0, 0, 1, 36
"/home/kapusta/Документы/programming_tasks/tinkoff/lin/b.cpp", "C++", 73, 0, 0, 4, 77
"/home/kapusta/Документы/programming_tasks/tinkoff/lin/c.cpp", "C++", 93, 0, 16, 4, 113
"/home/kapusta/Документы/programming_tasks/tinkoff/lin/c2.cpp", "C++", 27, 0, 22, 1, 50
"/home/kapusta/Документы/programming_tasks/tinkoff/lin/d.cpp", "C++", 59, 0, 12, 4, 75
"/home/kapusta/Документы/programming_tasks/tinkoff/lin/d2.cpp", "C++", 39, 0, 6, 7, 52
"/home/kapusta/Документы/programming_tasks/tinkoff/lin/e.cpp", "C++", 32, 0, 13, 2, 47
"/home/kapusta/Документы/programming_tasks/tinkoff/lin/el.cpp", "C++", 44, 0, 9, 1, 54
"/home/kapusta/Документы/programming_tasks/tinkoff/lin/f.cpp", "C++", 27, 0, 0, 1, 28
"/home/kapusta/Документы/programming_tasks/tinkoff/lin/g.cpp", "C++", 53, 0, 0, 3, 56
"/home/kapusta/Документы/programming_tasks/tinkoff/lin/g2.cpp", "C++", 52, 0, 6, 16, 74
"/home/kapusta/Документы/programming_tasks/tinkoff/lin/g3.cpp", "C++", 87, 0, 0, 4, 91
"/home/kapusta/Документы/programming_tasks/tinkoff/lin/p.py", "Python", 0, 8, 0, 2, 10
"/home/kapusta/Документы/programming_tasks/tinkoff/lin/testc.py", "Python", 0, 10, 0, 4, 14
"/home/kapusta/Документы/programming_tasks/tinkoff/nums/a.cpp", "C++", 29, 0, 0, 3, 32
"/home/kapusta/Документы/programming_tasks/tinkoff/nums/a2.cpp", "C++", 14, 0, 0, 1, 15
"/home/kapusta/Документы/programming_tasks/tinkoff/nums/b.cpp", "C++", 52, 0, 0, 3, 55
"/home/kapusta/Документы/programming_tasks/tinkoff/nums/b2.cpp", "C++", 48, 0, 0, 3, 51
"/home/kapusta/Документы/programming_tasks/tinkoff/nums/c.cpp", "C++", 46, 0, 0, 3, 49
"/home/kapusta/Документы/programming_tasks/tinkoff/nums/d.cpp", "C++", 78, 0, 0, 5, 83
"/home/kapusta/Документы/programming_tasks/tinkoff/nums/e.cpp", "C++", 16, 0, 0, 1, 17
"/home/kapusta/Документы/programming_tasks/tinkoff/nums/f.cpp", "C++", 21, 0, 0, 2, 23
"/home/kapusta/Документы/programming_tasks/tinkoff/nums/g.cpp", "C++", 19, 0, 0, 2, 21
"/home/kapusta/Документы/programming_tasks/tinkoff/nums/h.cpp", "C++", 26, 0, 0, 2, 28
"/home/kapusta/Документы/programming_tasks/tinkoff/nums/i.cpp", "C++", 18, 0, 0, 1, 19
"/home/kapusta/Документы/programming_tasks/tinkoff/nums/j.cpp", "C++", 33, 0, 1, 2, 36
"/home/kapusta/Документы/programming_tasks/tinkoff/nums/j2.cpp", "C++", 16, 0, 0, 1, 17
"/home/kapusta/Документы/programming_tasks/tinkoff/nums/j3.cpp", "C++", 32, 0, 0, 2, 34
"/home/kapusta/Документы/programming_tasks/tinkoff/nums/j4.cpp", "C++", 32, 0, 0, 2, 34
"/home/kapusta/Документы/programming_tasks/tinkoff/nums/j5.cpp", "C++", 16, 0, 0, 1, 17
"/home/kapusta/Документы/programming_tasks/tinkoff/nums/k.cpp", "C++", 35, 0, 0, 2, 37
"/home/kapusta/Документы/programming_tasks/tinkoff/nums/k2.cpp", "C++", 36, 0, 0, 2, 38
"/home/kapusta/Документы/programming_tasks/tinkoff/nums/l.cpp", "C++", 27, 0, 0, 3, 30
"/home/kapusta/Документы/programming_tasks/tinkoff/nums/m.cpp", "C++", 28, 0, 0, 3, 31
"/home/kapusta/Документы/programming_tasks/tinkoff/nums/n.cpp", "C++", 31, 0, 0, 2, 33
"/home/kapusta/Документы/programming_tasks/tinkoff/nums/o.cpp", "C++", 41, 0, 0, 3, 44
"/home/kapusta/Документы/programming_tasks/tinkoff/nums/p.cpp", "C++", 13, 0, 0, 1, 14
"/home/kapusta/Документы/programming_tasks/tinkoff/nums/p2.cpp", "C++", 13, 0, 0, 1, 14
"/home/kapusta/Документы/programming_tasks/tinkoff/nums/p3.cpp", "C++", 26, 0, 0, 2, 28
"/home/kapusta/Документы/programming_tasks/tinkoff/nums/p4.cpp", "C++", 38, 0, 3, 3, 44
"/home/kapusta/Документы/programming_tasks/tinkoff/nums/p5.cpp", "C++", 20, 0, 25, 3, 48
"/home/kapusta/Документы/programming_tasks/tinkoff/nums/p6.cpp", "C++", 25, 0, 3, 2, 30
"/home/kapusta/Документы/programming_tasks/tinkoff/perebor/a.cpp", "C++", 22, 0, 0, 2, 24
"/home/kapusta/Документы/programming_tasks/tinkoff/perebor/b.cpp", "C++", 26, 0, 0, 3, 29
"/home/kapusta/Документы/programming_tasks/tinkoff/perebor/c.cpp", "C++", 37, 0, 4, 4, 45
"/home/kapusta/Документы/programming_tasks/tinkoff/perebor/d.cpp", "C++", 29, 0, 0, 4, 33
"/home/kapusta/Документы/programming_tasks/tinkoff/perebor/e.cpp", "C++", 31, 0, 0, 4, 35
"/home/kapusta/Документы/programming_tasks/tinkoff/perebor/f.cpp", "C++", 28, 0, 0, 3, 31
"/home/kapusta/Документы/programming_tasks/tinkoff/perebor/g.cpp", "C++", 30, 0, 0, 3, 33
"/home/kapusta/Документы/programming_tasks/tinkoff/perebor/h.cpp", "C++", 33, 0, 0, 3, 36
"/home/kapusta/Документы/programming_tasks/tinkoff/perebor/i.cpp", "C++", 68, 0, 1, 5, 74
"/home/kapusta/Документы/programming_tasks/tinkoff/perebor/i2.cpp", "C++", 60, 0, 14, 6, 80
"/home/kapusta/Документы/programming_tasks/tinkoff/perebor/i3.cpp", "C++", 61, 0, 12, 7, 80
"/home/kapusta/Документы/programming_tasks/tinkoff/perebor/i4.cpp", "C++", 39, 0, 0, 4, 43
"/home/kapusta/Документы/programming_tasks/tinkoff/perebor/j.cpp", "C++", 43, 0, 0, 2, 45
"/home/kapusta/Документы/programming_tasks/tinkoff/perebor/k.cpp", "C++", 52, 0, 0, 3, 55
"/home/kapusta/Документы/programming_tasks/tinkoff/perebor/l.cpp", "C++", 28, 0, 1, 1, 30
"/home/kapusta/Документы/programming_tasks/tinkoff/perebor/l2.cpp", "C++", 41, 0, 0, 3, 44
"/home/kapusta/Документы/programming_tasks/tinkoff/perebor/l3.cpp", "C++", 29, 0, 0, 3, 32
"/home/kapusta/Документы/programming_tasks/tinkoff/perebor/m.cpp", "C++", 7, 0, 0, 2, 9
"/home/kapusta/Документы/programming_tasks/tinkoff/pref_twopointers/a.cpp", "C++", 18, 0, 6, 2, 26
"/home/kapusta/Документы/programming_tasks/tinkoff/pref_twopointers/b.cpp", "C++", 23, 0, 0, 1, 24
"/home/kapusta/Документы/programming_tasks/tinkoff/pref_twopointers/c.cpp", "C++", 22, 0, 0, 1, 23
"/home/kapusta/Документы/programming_tasks/tinkoff/pref_twopointers/d.cpp", "C++", 32, 0, 0, 1, 33
"/home/kapusta/Документы/programming_tasks/tinkoff/pref_twopointers/e.cpp", "C++", 27, 0, 0, 2, 29
"/home/kapusta/Документы/programming_tasks/tinkoff/pref_twopointers/f.cpp", "C++", 32, 0, 9, 3, 44
"/home/kapusta/Документы/programming_tasks/tinkoff/pref_twopointers/g.cpp", "C++", 32, 0, 1, 4, 37
"/home/kapusta/Документы/programming_tasks/tinkoff/pref_twopointers/h.cpp", "C++", 31, 0, 0, 2, 33
"/home/kapusta/Документы/programming_tasks/tinkoff/pref_twopointers/i.cpp", "C++", 32, 0, 0, 8, 40
"/home/kapusta/Документы/programming_tasks/tinkoff/pref_twopointers/testcr1.py", "Python", 0, 7, 0, 2, 9
"/home/kapusta/Документы/programming_tasks/tinkoff/pref_twopointers/testcreator.py", "Python", 0, 11, 0, 6, 17
"/home/kapusta/Документы/programming_tasks/tinkoff/scanline/a.cpp", "C++", 46, 0, 0, 5, 51
"/home/kapusta/Документы/programming_tasks/tinkoff/scanline/a2.cpp", "C++", 40, 0, 0, 3, 43
"/home/kapusta/Документы/programming_tasks/tinkoff/scanline/a3.cpp", "C++", 47, 0, 0, 3, 50
"/home/kapusta/Документы/programming_tasks/tinkoff/scanline/b.cpp", "C++", 62, 0, 23, 6, 91
"/home/kapusta/Документы/programming_tasks/tinkoff/scanline/b2.cpp", "C++", 86, 0, 28, 13, 127
"/home/kapusta/Документы/programming_tasks/tinkoff/scanline/b3.cpp", "C++", 49, 0, 22, 6, 77
"/home/kapusta/Документы/programming_tasks/tinkoff/scanline/c.cpp", "C++", 57, 0, 0, 3, 60
"/home/kapusta/Документы/programming_tasks/tinkoff/scanline/d.cpp", "C++", 47, 0, 0, 5, 52
"/home/kapusta/Документы/programming_tasks/tinkoff/scanline/d2.cpp", "C++", 35, 0, 0, 2, 37
"/home/kapusta/Документы/programming_tasks/tinkoff/scanline/d3.cpp", "C++", 45, 0, 3, 4, 52
"/home/kapusta/Документы/programming_tasks/tinkoff/scanline/d4.cpp", "C++", 53, 0, 0, 4, 57
"/home/kapusta/Документы/programming_tasks/tinkoff/scanline/d5.cpp", "C++", 43, 0, 2, 3, 48
"/home/kapusta/Документы/programming_tasks/tinkoff/scanline/d6.cpp", "C++", 48, 0, 0, 7, 55
"/home/kapusta/Документы/programming_tasks/tinkoff/scanline/d7.cpp", "C++", 46, 0, 2, 6, 54
"/home/kapusta/Документы/programming_tasks/tinkoff/scanline/d7cheat.cpp", "C++", 51, 0, 2, 5, 58
"/home/kapusta/Документы/programming_tasks/tinkoff/scanline/e.cpp", "C++", 41, 0, 0, 3, 44
"/home/kapusta/Документы/programming_tasks/tinkoff/scanline/e2.cpp", "C++", 48, 0, 7, 3, 58
"/home/kapusta/Документы/programming_tasks/tinkoff/scanline/e3.cpp", "C++", 41, 0, 3, 4, 48
"/home/kapusta/Документы/programming_tasks/tinkoff/scanline/e4.cpp", "C++", 44, 0, 14, 7, 65
"/home/kapusta/Документы/programming_tasks/tinkoff/scanline/f.cpp", "C++", 38, 0, 0, 3, 41
"/home/kapusta/Документы/programming_tasks/tinkoff/scanline/g.cpp", "C++", 13, 0, 0, 2, 15
"/home/kapusta/Документы/programming_tasks/tinkoff/scanline/tester.cpp", "C++", 16, 0, 0, 1, 17
"/home/kapusta/Документы/programming_tasks/tinkoff/sort/a.cpp", "C++", 27, 0, 0, 2, 29
"/home/kapusta/Документы/programming_tasks/tinkoff/sort/b.cpp", "C++", 27, 0, 0, 2, 29
"/home/kapusta/Документы/programming_tasks/tinkoff/sort/c.cpp", "C++", 34, 0, 0, 2, 36
"/home/kapusta/Документы/programming_tasks/tinkoff/sort/d.cpp", "C++", 30, 0, 0, 3, 33
"/home/kapusta/Документы/programming_tasks/tinkoff/sort/e.cpp", "C++", 31, 0, 0, 2, 33
"/home/kapusta/Документы/programming_tasks/tinkoff/sort/f.cpp", "C++", 18, 0, 0, 1, 19
"/home/kapusta/Документы/programming_tasks/tinkoff/sort/g.cpp", "C++", 17, 0, 0, 1, 18
"/home/kapusta/Документы/programming_tasks/tinkoff/sort/h.cpp", "C++", 41, 0, 0, 2, 43
"/home/kapusta/Документы/programming_tasks/tinkoff/sort/i.cpp", "C++", 34, 0, 0, 1, 35
"/home/kapusta/Документы/programming_tasks/tinkoff/sort/j.cpp", "C++", 31, 0, 0, 1, 32
"/home/kapusta/Документы/programming_tasks/tinkoff/sort/k.cpp", "C++", 28, 0, 0, 1, 29
"/home/kapusta/Документы/programming_tasks/tinkoff/sort/l.cpp", "C++", 24, 0, 0, 2, 26
"/home/kapusta/Документы/programming_tasks/tinkoff/sort/m.cpp", "C++", 81, 0, 8, 7, 96
"/home/kapusta/Документы/programming_tasks/tinkoff/sort/m2.cpp", "C++", 70, 0, 8, 6, 84
"/home/kapusta/Документы/programming_tasks/tinkoff/sort/n.cpp", "C++", 52, 0, 0, 4, 56
"/home/kapusta/Документы/programming_tasks/tinkoff/sort/n2.cpp", "C++", 55, 0, 0, 4, 59
"/home/kapusta/Документы/programming_tasks/tinkoff/sort/n3.cpp", "C++", 52, 0, 0, 5, 57
"/home/kapusta/Документы/programming_tasks/tinkoff/sort/n4.cpp", "C++", 36, 0, 7, 4, 47
"/home/kapusta/Документы/programming_tasks/tinkoff/sort/n5.cpp", "C++", 53, 0, 0, 4, 57
"/home/kapusta/Документы/programming_tasks/tinkoff/sort/o.cpp", "C++", 37, 0, 0, 2, 39
"/home/kapusta/Документы/programming_tasks/tinkoff/stack_deck/a.cpp", "C++", 31, 0, 0, 2, 33
"/home/kapusta/Документы/programming_tasks/tinkoff/stack_deck/b.cpp", "C++", 33, 0, 0, 2, 35
"/home/kapusta/Документы/programming_tasks/tinkoff/stack_deck/c.cpp", "C++", 43, 0, 0, 2, 45
"/home/kapusta/Документы/programming_tasks/tinkoff/stack_deck/d.cpp", "C++", 47, 0, 0, 1, 48
"/home/kapusta/Документы/programming_tasks/tinkoff/stack_deck/e.cpp", "C++", 55, 0, 0, 2, 57
"/home/kapusta/Документы/programming_tasks/tinkoff/stack_deck/f.cpp", "C++", 66, 0, 0, 3, 69
"/home/kapusta/Документы/programming_tasks/tinkoff/stack_deck/g.cpp", "C++", 46, 0, 0, 2, 48
"/home/kapusta/Документы/programming_tasks/tinkoff/stack_deck/h.cpp", "C++", 22, 0, 0, 1, 23
"/home/kapusta/Документы/programming_tasks/tinkoff/stack_deck/j.cpp", "C++", 28, 0, 0, 1, 29
"/home/kapusta/Документы/programming_tasks/tinkoff_dop/a.cpp", "C++", 8, 0, 0, 1, 9
"/home/kapusta/Документы/programming_tasks/tinkoff_trenirovki/a.cpp", "C++", 32, 0, 0, 3, 35
"/home/kapusta/Документы/programming_tasks/tinkoff_trenirovki/b.cpp", "C++", 8, 0, 0, 2, 10
"/home/kapusta/Документы/programming_tasks/vprob/a.cpp", "C++", 17, 0, 0, 2, 19
"/home/kapusta/Документы/programming_tasks/vprob/b.cpp", "C++", 29, 0, 7, 1, 37
"/home/kapusta/Документы/programming_tasks/vprob/b2.cpp", "C++", 38, 0, 2, 1, 41
"/home/kapusta/Документы/programming_tasks/vprob/b3.cpp", "C++", 38, 0, 7, 1, 46
"/home/kapusta/Документы/programming_tasks/vprob/c.cpp", "C++", 34, 0, 11, 3, 48
"/home/kapusta/Документы/programming_tasks/нарешка/2004-2005/ojer.py", "Python", 0, 1, 0, 2, 3
"/home/kapusta/Документы/programming_tasks/нарешка/2004-2005/tele.py", "Python", 0, 10, 0, 5, 15
"/home/kapusta/Документы/programming_tasks/нарешка/2004-2005/tramvai.py", "Python", 0, 26, 0, 2, 28
"/home/kapusta/Документы/programming_tasks/нарешка/2004-2005/wb_graphick.cpp", "C++", 40, 0, 12, 2, 54
"/home/kapusta/Документы/programming_tasks/нарешка/itmo/sys.py", "Python", 0, 15, 1, 0, 16
"/home/kapusta/Документы/programming_tasks/нарешка/itmo/vesi.cpp", "C++", 4, 0, 0, 1, 5
"/home/kapusta/Документы/programming_tasks/нарешка/itmo/vesi.py", "Python", 0, 29, 4, 6, 39
"/home/kapusta/Документы/programming_tasks/нарешка/scool_et/am_gor.py", "Python", 0, 35, 0, 5, 40
"/home/kapusta/Документы/programming_tasks/нарешка/scool_et/let.py", "Python", 0, 8, 0, 4, 12
"/home/kapusta/Документы/programming_tasks/нарешка/scool_et/proj.py", "Python", 0, 11, 0, 1, 12
"/home/kapusta/Документы/programming_tasks/нарешка/scool_et/shit.py", "Python", 0, 13, 1, 2, 16
"/home/kapusta/Документы/programming_tasks/нарешка/scool_et/sup.cpp", "C++", 22, 0, 0, 2, 24
"/home/kapusta/Документы/programming_tasks/нарешка/scool_et/sup.py", "Python", 0, 14, 0, 2, 16
"/home/kapusta/Документы/programming_tasks/нарешка/ВСОШ/munik/a.cpp", "C++", 12, 0, 0, 1, 13
"/home/kapusta/Документы/programming_tasks/нарешка/ВСОШ/school/a.cpp", "C++", 33, 0, 12, 2, 47
"/home/kapusta/Документы/programming_tasks/нарешка/ВСОШ/school/a.py", "Python", 0, 5, 0, 1, 6
"/home/kapusta/Документы/programming_tasks/нарешка/ВСОШ/school/b.cpp", "C++", 19, 0, 0, 1, 20
"/home/kapusta/Документы/programming_tasks/нарешка/ВСОШ/school/b.py", "Python", 0, 4, 0, 1, 5
"/home/kapusta/Документы/programming_tasks/нарешка/ВСОШ/school/c.cpp", "C++", 50, 0, 13, 2, 65
"/home/kapusta/Документы/programming_tasks/нарешка/ВСОШ/school/c.py", "Python", 0, 3, 0, 3, 6
"/home/kapusta/Документы/programming_tasks/нарешка/ВСОШ/school/perfocards.cpp", "C++", 28, 0, 0, 2, 30
"/home/kapusta/Документы/programming_tasks/нарешка/ВСОШ/school/rndmin.py", "Python", 0, 7, 1, 2, 10
"/home/kapusta/Документы/programming_tasks/нарешка/ИОИП/akcii.cpp", "C++", 33, 0, 0, 2, 35
"/home/kapusta/Документы/programming_tasks/нарешка/ИОИП/akcii.py", "Python", 0, 17, 0, 4, 21
"/home/kapusta/Документы/programming_tasks/нарешка/РОИ/kasik.cpp", "C++", 51, 0, 1, 4, 56
"/home/kapusta/Документы/programming_tasks/нарешка/РОИ/mem_manager.cpp", "C++", 47, 0, 3, 1, 51
"/home/kapusta/Документы/programming_tasks/нарешка/РОИ/mem_manager.py", "Python", 0, 27, 3, 4, 34
"/home/kapusta/Документы/programming_tasks/нарешка/РОИ/ojerel.cpp", "C++", 101, 0, 2, 6, 109
"/home/kapusta/Документы/programming_tasks/нарешка/РОИ/ojerel.py", "Python", 0, 18, 2, 3, 23
"/home/kapusta/Документы/programming_tasks/нарешка/РОИ/perfocards.py", "Python", 0, 0, 0, 1, 1
"/home/kapusta/Документы/programming_tasks/смена/задачи/2.cpp", "C++", 27, 0, 0, 6, 33
"/home/kapusta/Документы/programming_tasks/смена/задачи/Commercial_calculator.cpp", "C++", 4, 0, 0, 1, 5
"/home/kapusta/Документы/programming_tasks/смена/задачи/Hash.cpp", "C++", 35, 0, 0, 1, 36
"/home/kapusta/Документы/programming_tasks/смена/задачи/Pobeda-2014.cpp", "C++", 9, 0, 0, 1, 10
"/home/kapusta/Документы/programming_tasks/смена/задачи/Spisik_shkol.cpp", "C++", 22, 0, 0, 2, 24
"/home/kapusta/Документы/programming_tasks/смена/задачи/Struct_S_castom.cpp", "C++", 49, 0, 0, 5, 54
"/home/kapusta/Документы/programming_tasks/смена/задачи/Struct_S_set.cpp", "C++", 23, 0, 0, 3, 26
"/home/kapusta/Документы/programming_tasks/смена/задачи/alley.cpp", "C++", 28, 0, 0, 1, 29
"/home/kapusta/Документы/programming_tasks/смена/задачи/avtomatiz_sk.cpp", "C++", 39, 0, 7, 4, 50
"/home/kapusta/Документы/programming_tasks/смена/задачи/binary_struct_1.cpp", "C++", 74, 0, 1, 11, 86
"/home/kapusta/Документы/programming_tasks/смена/задачи/bintree.cpp", "C++", 126, 0, 1, 16, 143
"/home/kapusta/Документы/programming_tasks/смена/задачи/borba_s_rutinoi.cpp", "C++", 26, 0, 0, 2, 28
"/home/kapusta/Документы/programming_tasks/смена/задачи/bsr.cpp", "C++", 27, 0, 0, 2, 29
"/home/kapusta/Документы/programming_tasks/смена/задачи/fib.cpp", "C++", 21, 0, 0, 2, 23
"/home/kapusta/Документы/programming_tasks/смена/задачи/mmm.cpp", "C++", 23, 0, 0, 6, 29
"/home/kapusta/Документы/programming_tasks/смена/задачи/num1.cpp", "C++", 50, 0, 5, 7, 62
"/home/kapusta/Документы/programming_tasks/смена/задачи/operand_peregruz.cpp", "C++", 23, 0, 0, 3, 26
"/home/kapusta/Документы/programming_tasks/смена/задачи/podstroka.cpp", "C++", 13, 0, 0, 1, 14
"/home/kapusta/Документы/programming_tasks/смена/задачи/py.py", "Python", 0, 9, 0, 2, 11
"/home/kapusta/Документы/programming_tasks/смена/задачи/reg1.cpp", "C++", 11, 0, 1, 1, 13
"/home/kapusta/Документы/programming_tasks/смена/задачи/reg2.cpp", "C++", 17, 0, 0, 1, 18
"/home/kapusta/Документы/programming_tasks/смена/задачи/reg3.cpp", "C++", 40, 0, 4, 3, 47
"/home/kapusta/Документы/programming_tasks/смена/задачи/reg4.cpp", "C++", 16, 0, 0, 3, 19
"/home/kapusta/Документы/programming_tasks/смена/задачи/reg5.cpp", "C++", 21, 0, 0, 5, 26
"/home/kapusta/Документы/programming_tasks/смена/задачи/reg6.cpp", "C++", 22, 0, 0, 1, 23
"/home/kapusta/Документы/programming_tasks/смена/задачи/ruksak.cpp", "C++", 19, 0, 0, 2, 21
"/home/kapusta/Документы/programming_tasks/смена/задачи/strochki.cpp", "C++", 7, 0, 0, 2, 9
"/home/kapusta/Документы/programming_tasks/смена/задачи/triangles.cpp", "C++", 60, 0, 16, 8, 84
"/home/kapusta/Документы/programming_tasks/смена/задачи/triangles2.py", "Python", 0, 2, 0, 1, 3
"/home/kapusta/Документы/programming_tasks/смена/задачи/trie.cpp", "C++", 82, 0, 19, 16, 117
"/home/kapusta/Документы/programming_tasks/смена/задачи/vec1.cpp", "C++", 43, 0, 0, 9, 52
"/home/kapusta/Документы/programming_tasks/смена/задачи/vec2.cpp", "C++", 15, 0, 0, 1, 16
"/home/kapusta/Документы/programming_tasks/смена/задачи/zero_one.cpp", "C++", 32, 0, 0, 6, 38
"/home/kapusta/Документы/programming_tasks/смена/задачи/zero_one1.cpp", "C++", 25, 0, 4, 6, 35
"/home/kapusta/Документы/programming_tasks/смена/командная олимпиада/1.cpp", "C++", 8, 0, 0, 1, 9
"/home/kapusta/Документы/programming_tasks/смена/командная олимпиада/10.cpp", "C++", 39, 0, 0, 1, 40
"/home/kapusta/Документы/programming_tasks/смена/командная олимпиада/2.cpp", "C++", 55, 0, 0, 3, 58
"/home/kapusta/Документы/programming_tasks/смена/командная олимпиада/3.cpp", "C++", 10, 0, 0, 1, 11
"/home/kapusta/Документы/programming_tasks/смена/командная олимпиада/4.cpp", "C++", 32, 0, 0, 5, 37
"/home/kapusta/Документы/programming_tasks/смена/командная олимпиада/5.cpp", "C++", 39, 0, 2, 1, 42
"/home/kapusta/Документы/programming_tasks/смена/командная олимпиада/6.cpp", "C++", 18, 0, 0, 4, 22
"/home/kapusta/Документы/programming_tasks/смена/командная олимпиада/7.cpp", "C++", 20, 0, 0, 1, 21
"/home/kapusta/Документы/programming_tasks/смена/командная олимпиада/8.cpp", "C++", 10, 0, 0, 4, 14
"/home/kapusta/Документы/programming_tasks/смена/командная олимпиада/9.cpp", "C++", 41, 0, 3, 6, 50
"/home/kapusta/Документы/programming_tasks/смена/личная олимпиада/1.cpp", "C++", 27, 0, 1, 6, 34
"/home/kapusta/Документы/programming_tasks/смена/личная олимпиада/b.cpp", "C++", 26, 0, 1, 1, 28
"/home/kapusta/Документы/programming_tasks/смена/личная олимпиада/c.cpp", "C++", 19, 0, 0, 4, 23
"/home/kapusta/Документы/programming_tasks/смена/личная олимпиада/e.cpp", "C++", 29, 0, 1, 2, 32
"Total", "-", 20330, 1061, 1502, 1886, 24779